WWWWWWWWWW
W...W.W..W
WW.......W
W...W...sW
W...WW.W.W
W.WW.....W
W....W.WWW
W........W
WW.c.....W
WWWWWWWWWW
