WWWWWWWWWWWWWWWWWWWW
WWWWWWWWWWWWWWWWWWWW
WW......WW..WW....WW
WW......WW..WW....WW
WWWW..............WW
WWWW..............WW
WW......WW.......sWW
WW......WW........WW
WW......WWWW..WW..WW
WW......WWWW..WW..WW
WW..WWWW..........WW
WW..WWWW..........WW
WW........WW..WWWWWW
WW........WW..WWWWWW
WW................WW
WW.........c......WW
WWWW..............WW
WWWW..............WW
WWWWWWWWWWWWWWWWWWWW
WWWWWWWWWWWWWWWWWWWW
