WWWWWWWWWW
W...W..W.W
Wc..W....W
W.....W.WW
W..W..WW.W
W...s....W
Wb.W....WW
W..W..W.WW
W.W...W..W
WWWWWWWWWW
