WWWWWWWWWWWWWWWWWWWW
WWWWWWWWWWWWWWWWWWWW
WW......WW....WW..WW
WW......WW....WW..WW
WW.c....WW........WW
WW......WW........WW
WW..........WW..WWWW
WW..........WW..WWWW
WW....WW....WWWW..WW
WW....WW....WWWW..WW
WW.......s........WW
WW................WW
WW....WW........WWWW
WW.b..WW........WWWW
WW....WW....WW..WWWW
WW....WW....WW..WWWW
WW..WW......WW....WW
WW..WW......WW....WW
WWWWWWWWWWWWWWWWWWWW
WWWWWWWWWWWWWWWWWWWW
